4
2
2 1
15 15
0 0 0 0 0 0 0 0 0 0 0 0 0 0 0
0 0 0 0 0 0 0 0 0 0 0 0 0 0 0
i 0 0 0 0 0 0 0 0 0 0 1 2 0 0
0 0 0 0 0 0 0 0 0 0 0 2 1 0 0
0 0 0 0 0 0 0 c 0 0 0 0 0 0 0
0 0 0 0 0 - - - - - 0 0 0 0 0
x 0 0 0 0 - - - - - 0 0 0 0 x
0 x 0 0 b - - - - - b 0 0 x 0
x 0 0 0 0 - - - - - 0 0 0 0 x
0 0 0 0 0 - - - - - 0 0 0 0 0
0 0 0 0 0 0 0 c 0 0 0 0 0 0 0
0 0 3 4 0 0 0 0 0 0 0 0 0 0 0
0 0 4 3 0 0 0 0 0 0 0 0 0 0 i
0 0 0 0 0 0 0 0 0 0 0 0 0 0 0
0 0 0 0 0 0 0 0 0 0 0 0 0 0 0
4 4 3 <-> 10 10 7
10 4 5 <-> 4 10 1