8
8
4 4
20 30
0 0 0 0 - - - - 0 0 0 0 0 0 0 0 0 0 0 0 0 0 - - - - 0 0 0 0
0 0 0 0 - - - - 0 0 0 0 0 0 0 0 0 0 0 0 0 0 - - - - 0 0 0 0
0 0 0 0 - - - - 0 0 0 0 0 0 0 0 0 0 0 0 0 0 - - - - 0 0 0 0
0 0 0 0 - - - - 0 0 0 0 0 0 0 0 0 0 0 0 0 0 - - - - 0 0 0 0
0 0 0 0 c 0 0 i 0 0 0 0 0 0 1 2 0 0 0 0 0 0 i 0 0 c 0 0 0 0
0 0 0 0 0 0 0 0 0 0 0 0 0 0 1 2 0 0 0 0 0 0 0 0 0 0 0 0 0 0
0 0 0 0 0 0 0 0 0 0 0 0 0 0 0 0 0 0 0 0 0 0 0 0 0 0 0 0 0 0
0 0 0 0 0 0 0 0 0 0 0 0 0 0 3 4 0 0 0 0 0 0 0 0 0 0 0 0 0 0
0 0 0 b 0 0 0 x 0 x 0 0 0 0 3 4 0 0 0 0 x 0 x 0 0 0 b 0 0 0
0 0 0 0 0 0 0 0 x 0 0 0 0 0 0 0 0 0 0 0 0 x 0 0 0 0 0 0 0 0
0 0 0 0 0 0 0 0 x 0 0 0 0 0 0 0 0 0 0 0 0 x 0 0 0 0 0 0 0 0
0 0 0 b 0 0 0 x 0 x 0 0 0 0 5 6 0 0 0 0 x 0 x 0 0 0 b 0 0 0
0 0 0 0 0 0 0 0 0 0 0 0 0 0 5 6 0 0 0 0 0 0 0 0 0 0 0 0 0 0
0 0 0 0 0 0 0 0 0 0 0 0 0 0 0 0 0 0 0 0 0 0 0 0 0 0 0 0 0 0
0 0 0 0 0 0 0 0 0 0 0 0 0 0 7 8 0 0 0 0 0 0 0 0 0 0 0 0 0 0
0 0 0 0 c 0 0 i 0 0 0 0 0 0 7 8 0 0 0 0 0 0 i 0 0 c 0 0 0 0
0 0 0 0 - - - - 0 0 0 0 0 0 0 0 0 0 0 0 0 0 - - - - 0 0 0 0
0 0 0 0 - - - - 0 0 0 0 0 0 0 0 0 0 0 0 0 0 - - - - 0 0 0 0
0 0 0 0 - - - - 0 0 0 0 0 0 0 0 0 0 0 0 0 0 - - - - 0 0 0 0
0 0 0 0 - - - - 0 0 0 0 0 0 0 0 0 0 0 0 0 0 - - - - 0 0 0 0
3 1 2 <-> 26 1 6
8 1 6 <-> 21 1 2
3 18 2 <-> 26 18 6
8 18 6 <-> 21 18 2