8
4
1 3
15 15
- - - - - b 0 x 0 b - - - - -
- - - 0 0 0 x x x 0 0 0 - - -
- - 0 0 0 0 0 x 0 0 0 0 0 - -
- 0 0 1 2 0 0 0 0 0 1 2 0 0 -
- 0 0 3 4 0 - - - 0 3 4 0 0 -
c 0 0 0 0 - - - - - 0 0 0 0 i
0 x 0 0 - - - - - - - 0 0 x 0
x x x 0 - - - - - - - 0 x x x
0 x 0 0 - - - - - - - 0 0 x 0
i 0 0 0 0 - - - - - 0 0 0 0 c
- 0 0 5 6 0 - - - 0 5 6 0 0 -
- 0 0 7 8 0 0 0 0 0 7 8 0 0 -
- - 0 0 0 0 0 x 0 0 0 0 0 - -
- - - 0 0 0 x x x 0 0 0 - - -
- - - - - b 0 x 0 b - - - - -
0 5 6 <-> 14 5 2 
0 9 6 <-> 14 9 2
5 0 0 <-> 5 14 4
9 0 0 <-> 9 14 4