4
6
2 3
14 18
- - - - - 0 0 0 0 0 0 0 0 - - - - -
- - - - - 0 0 0 0 0 0 0 0 - - - - -
- - - 0 0 0 0 0 b b 0 0 0 0 0 - - -
- - - c 0 0 0 0 0 0 0 0 0 0 c - - -
- 0 0 0 0 0 0 0 0 0 0 0 0 0 0 0 0 -
- 0 0 0 0 0 x i - - i x 0 0 0 0 0 -
1 2 2 0 0 0 0 - - - - 0 0 0 0 4 4 3 
2 1 1 0 0 0 0 - - - - 0 0 0 0 3 3 4 
- 0 0 0 0 0 x i - - i x 0 0 0 0 0 -
- 0 0 0 0 0 0 0 0 0 0 0 0 0 0 0 0 -
- - - c 0 0 0 0 0 0 0 0 0 0 c - - -
- - - 0 0 0 0 0 b b 0 0 0 0 0 - - -
- - - - - 0 0 0 0 0 0 0 0 - - - - -
- - - - - 0 0 0 0 0 0 0 0 - - - - -
5 13 6 <-> 12 0 2
8 13 4 <-> 7 9 1 
9 13 4 <-> 10 9 7
8 0 0 <-> 7 4 3
9 0 0 <-> 10 4 5
