3
3
2 1
15 15
- - - - - 0 3 2 1 0 - - - - -
- - - 0 0 0 0 0 0 0 0 0 - - -
- - 0 0 0 0 0 0 0 0 0 0 0 - -
- 0 0 0 0 0 0 0 0 0 0 0 0 0 -
- 0 0 0 0 0 0 0 0 0 0 0 0 0 -
0 0 0 0 0 - 0 0 0 - 0 0 0 0 0
2 0 0 0 0 0 1 2 3 0 0 0 0 0 1
3 0 0 0 0 0 3 1 2 0 0 0 0 0 2
1 0 0 0 0 0 2 3 1 0 0 0 0 0 3
0 0 0 0 0 - 0 0 0 - 0 0 0 0 0
- 0 0 0 0 0 0 0 0 0 0 0 0 0 -
- 0 0 0 0 0 0 0 0 0 0 0 0 0 -
- - 0 0 0 0 0 0 0 0 0 0 0 - -
- - - 0 0 0 0 0 0 0 0 0 - - -
- - - - - 0 1 3 2 0 - - - - -
0 5 6 <-> 14 5 2 
0 9 6 <-> 14 9 2
5 0 0 <-> 5 14 4
9 0 0 <-> 9 14 4

